PALAVRAS RELATIVAS A ALIMENTOS EM INGLÊS

Egg - Ovo
Bread - Pão
Cheese - Queijo
Meat - Carne
Fish - Peixe
Sugar - Açúcar
Pepper - Pimenta
Rice - Arroz
Fruits - Frutas
Apple - Maçã
Lemon - Limão
Orange - Laranja
Pineapple - Abacaxi
Peaches - Pêssego
Strawberries - Morango
Papaya - Mamão
Watermelon - Melancia
Coconut - Coco
Tomato - Tomate
Potato - Batata
Guava
Tomato
Potato
Beans
Carrots
Garlic
Pop Corn

PALAVRAS RELATIVAS AO CONTEXTO ESCOLAR EM INGLÊS

Student - Estudante
Classroom - Sala de Aula
Teacher - Professor
Pen - Caneta
Eraser - Borracha
Book - Livro
Exam - Prova
Library - Biblioteca
Principal - Diretor
Auditorium - Auditório

PALAVRAS RELACIONADAS A MEIO DE TRANSPORTE EM INGLÊS

Bicycle – Bicicleta
Ship - Navio
Bus – Ônibus
Car – Carro
Chopper or Helipcoter - Helicóptero 
Motorbike – Motocicleta
Boat - Barco
Pickup truck – Caminhonete
Roller skates – Patins
Scooter – Patinete
Skateboard – Skate
Streetcar – Bonde
Subway – Metro
Taxi cab – Táxi
Train – Trem
Airplane - Avião