 Palavras do contexto de utensílios de cozinha :

Panela - Pan

Frigideira - Frying Pan

Garfo - Fork 

Faca - Knife

Colher - Spoon 

Espátula - Spatula 

Concha - Ladle
 
xicaras - Cup 

Copos - Cup

Pratos - Plates

Garrafa Térmica - Thermal Bottle 

Chaleira - Kettle 

Escorredor - Drainer 

Panela de Pressão - Pressure Cooker 

Colheres de Pau - Wooden Spoon 

coedor de café - Coffee Filter

Cuscuzeira -  Cuscuzeira 

Forma de bolo  -  Cake Pan 

Travessas - Serving Dish 

Jarras - Jar 

 Palavras do contexto de mobília :

Mesa - Table 

Cadeira - Chair 

Sofá - Couch 

cama -Bed 

Guarda Roupas - Wardrobe 

Cômoda - Dresser 

Armário - Wardrobe 

Criado mudo - Nightstand 
 
Fruteira - Fruit bowl 

Cortinas - Curtains

 Palavras do contexto de eletrodomésticos:

Microondas - Microwave 

Fogão - Cooker 

Máquina de lavar roupas - Washing Machine

Ventilador - Fan 

Geladeira - Refrigerator 

Televisão - Television 

Aspirador - Aspirator 

Sanduicheira - Sandwich Maker 

Liquidificador - Blender 

Rádio - Radio 

Freezer - Freezer 

Cafeteira - Coffe Machine 

Ar condicionado - Air Conditioning 

Ferro de passar roupas - Clothes Iron 

Batedeira - Food Mixer 

